111111111111
1CEP000CC001
101110011101
101010010101
101110011101
100000000001
101010010101
111100001111
101010010101
10000C000001
101110011101
101010010101
101110011101
10000000C001
111111111111

