111111111111111
100000000000001
101110111011101
101000010000101
101010000010101
100000000000001
101000E1C000101
101100111001101
101000C1P000101
100000000000001
101010000010101
101000010000101
101110111011101
100000000000001
111111111111111

