111111111111
1CEP000CC001
101110C11101
101010010101
10111C011101
111111111111

