111111111111111
100000000000001
101110111011101
101000010000101
101010P00010101
101010000010101
101000010000101
101110111011101
1E000000C000001
111111111111111

