111111111111
1CEP000CC001
101110C11101
101010010101
10111C011101
100000000001
10101C010101
111100001111
101010C10101
10000C000001
101110011101
101010C10101
10111C011101
10000000C001
111111111111

