1111111111111111
1000000000000001
1011100000011101
101P00010000C101
1010001110000101
101C00010000E101
1011100000011101
1000000000000001
1111111111111111
