1111111
1000001
10CEP01
1000001
1100011