1111111
1000001
100EP01
1000001
1111111