1111111
1000001
10C0P01
1000001
1111111