11111111111
1CCCCCCCCC1
1EEEEEEEEE1
1PPPPPPPPP1
11111111111