1111111
1000001
10CE001
1000001
1111111