1111111
1000001
10CEP01
100E001
1111111