1111111
1000001
10CEP01
1000P01
1111111