1111111
1     1
1 CEP 1
1     1
1111111