11111111
1000001
1CEP1
1000001
11111111