1111111
1P0C001
1000111
1C001E1
1111111