111111111111111111
10001000C00000C001
10P01010111C111001
100010000C101C0001
101C11C111111101C1
1000100110C0110001
10001C11001001C101
1C101001C11C111101
100011C10E1001C101
100010011111C10001
101C1C110C010101C1
1000100C010C010001
101111111111111101
1C0C10CC0110CC01C1
10C010110110110101
1C0C0000CC00000C01
111111111111111111