1111
1P01
11C1
1001
1C11
1001
11C1
1001
1C11
10E1
1111