1111111111111111111111111
1000C00000C00001100000001
10111111111111C11C1111101
1010C1100C001000100001101
101011001110101C1111C0101
1010000111101011111110101
10111011111010011CC1101C1
10110011011011011CC110101
10100110011C01C0001110101
10C01111111101100111C0101
11111111111101C0111E001C1
11100001P1100101111111101
10C0110101101101111111101
1010C10C011011000001C0101
10111111110C1C01110110101
10000C000001110C1C0000C01
1111111111111111111111111