11111111111
1P000C100C1
11111010111
10C0101C001
10101011101
10000C00001
10101111111
10101000001
10101C00101
10111101111
1C0000C01E1
11111111111