11111111111111111111111111111111
11000000000000000000000000000011
10001111110101111110101111110001
10111011010000100100001011011101
10101111111111111111111111110101
101111C1100110011CC110011C111101
10011000111100000000111100011001
1000101C100C01C111101C00C1010001
10101C11101101P11E10110111C10101
1000101C00C101111C10C001C1010001
10011000111100000000111100011001
101111C110011CC1100110011C111101
10101111111111111111111111110101
10111011010000101000001011011101
10001111110101111101001111110001
11000000000000000000000000000011
11111111111111111111111111111111